11111111111111111111111111111111111
10000000000000000000000000000000001
100000000000000000000000000000C0001
10000000000000000000000000000000001
10000000000000000000000000000000001
10000000000000000000000000000000001
10000000000000000000000000000000001
1000000P000000000000000000000000001
10000000000000000000000000000000001
10000000000000000000000000000000001
10000000000000000000000000000000001
10000000000000000000000000C00000001
10000000000000000000000000000000001
11111111111000000000000000000000001
11111111111110000000000000000000001
11111111111111000000000000000000001
11111111111111100000000000000000001
11111111111111100000000000000000001
10000000000000000000000000000000001
10000000000000000000000000000000001
10000000000000000000000000000000001
10000000000000000000000000000000001
10000000000000000000000000000000001
10000000000000000000000000000000001
10000000000000000000000000000000001
10000000000000000000000000000000001
10000000000000000000000000000000001
1000000000C000000000000000000000001
1000000000000000000000000000E000001
10000000000000000000000000000000001
10000000000000000000000000000000001
10000000000000000000000000000000001
10000000000000000000000000000000001
10000000000000000000000000000000001
11111111111111111111111111111111111
